NO ./img/bluestone.xpm

SO ./img/colorstone.xpm

WE ./img/eagle.xpm

EA ./img/wood.xpm

F 255,255,255

C 0,0,1

1111111111
11100000000
11100011111
11110111111
10101000001
10000000001
100N0000001
11111111111