NO ./img/bluestone.xpm

SO ./img/colorstone.xpm

WE ./img/eagle.xpm

EA ./img/wood.xpm

F 220,100,100

C 225,30,0
1111111111
11100011111
11100011111
11100011111
10100000001
10000000001
100N0000001
11111111111