NO ./img/bluestone.xpm
SO ./img/colorstone.xpm
WE ./img/eagle.xpm
EA ./img/wood.xpm

F 220,100,0
C 225,30,0

1111111111111111111111111
1000000000110000000000001
1011000001110000000000001
1001000000000000000000001
111111111011000001110000111111111
100000000011000001110111111111111
11110111111111011100000010001
11110111111111011101010010001        111111
110000001101010111000001010001       100001
10000000000000001100000000001        111111
10000000000000001101010011101
1100000111010101111101111000111
11110111 1110101 1011110100S1
11111111 1111111 111111111111